A Collection of Essays|by George Orwell|Orwell George
A Beautiful Game: The World's Greatest Players and How Soccer Changed Their Lives|by Tom Watt|Watt Tom
Sports Illustrated NFL Quarterback: The Greatest Position in Sport|by the Sports Illustrated Editors|Sports Illustrated Editors
Sports Illustrated: The Basketball Book|by the Sports Illustrated Editors|Sports Illustrated Editors
The Bhagavad Gita|translated by Barbara Stoler Miller|Vyasa
The Jazz of Physics: The Secret Link Between Music and the Structure of the Universe|by Stephon Alexander|Alexander Stephon
Meditations|by Marcus Aurelius|Aurelius Marcus
The New York Trilogy|by Paul Auster|Auster Paul
The ESPN Uncyclopedia|by Gary Belsky and Neil Fine|Belsky Gary
The System: The Glory and Scandal of Big-Time College Football|by Jeff Benedict and Armen Keteyian|Benedict Jeff Fine Neil
City of Thieves|by David Benioff|Benioff David
Ways of Seeing|by John Berger|Berger John
Bastard Tongues: A Trailblazing Linguist Finds Clues to Our Common Humanity in the World's Lowliest Languages|by Derek Bickerton|Bickerton Derek
The Rise and Fall of the Dinosaurs: A New History of Their Lost World|by Steve Brusatte|Brusatte Steve
A Short History of Nearly Everything|by Bill Bryson|Bryson Bill
A Walk in the Woods: Rediscovering America on the Appalachian Trail|by Bill Bryson|Bryson Bill
Quiet: The Power of Introverts in a World that Can't Stop Talking|by Susan Cain|Cain Susan
Players First: Coaching from the Inside Out|by John Calipari|Calipari John
How to Win Friends and Influence People|by Dale Carnegie|Carnegie Dale
Bad Blood: Secrets and Lies in a Silicon Valley Startup|by John Carreyrou|Carreyrou John
Gifted Hands: The Ben Carson Story|by Ben Carson|Carson Ben
10 Days: Benjamin Franklin|by David Colbert|Colbert David
Good to Great: Why Some Companies Make the Leap...and Others Don't|by Jim Collins|Collins Jim
Talent is Overrated: What Really Separated World-Class Performers from Everybody Else|by Geoff Colvin|Colvin Geoff
The Quantum Moment: How Planck, Bohr, Einstein, and Heisenberg Taught Us to Love Uncertainty|by Robert P. Crease and Alfred Scharff Goldhaber|Crease Robert P. Goldhaber Alfred Scharff
Flow: The Psychology of Optimal Experience|by Mihaly Csikszentmihalyi|Csikszentmihalyi Mihaly
City of God|by EL Doctorow|Doctorow EL
Managing Oneself|by Peter Drucker|Drucker Peter
The Power of Habit: Why We Do What We Do in Life and Business|by Charles Duhigg|Duhigg Charles
What is the What|by Dave Eggers|Eggers Dave
The Annotated Waste Land with Eliot's Contemporary Prose|by TS Eliot (edited by Lawrence Rainey)|Eliot TS
The Cocktail Party|by TS Eliot|Eliot TS
100 Deadly Skills: The SEAL Operative's Guide to Eluding Persuers, Evading Capture, and Surviving Any Dangerous Situation|by Clint Emerson|Emerson Clint
The Sports Gene: Inside the Science of Extraordinary Athletic Performance|by David Epstein|Epstein David
Peak: Secrets from the New Science of Expertise|by K. Anders Ericsson|Ericsson K. Anders
Escher On Escher: Exploring the Infinite|by M.C. Escher|Escher M.C.
The 4-Hour Workweek: Escape 9-5, Live Anywhere, and Join the New Rich|by Timothy Ferriss|Ferriss Timothy
Six Easy Pieces: Essentials of Physics By Its Most Brilliant Teacher|by Richard P. Feynman|Feynman Richard P.
Where Nobody Knows Your Name: Life In the Minor Leagues of Baseball|by John Feinstein|Feinstein John
Sports Illustrated: The Football Book|by Rob Fleder and Rick Reilly|Fleder Rob Reilly Rick
The Great Gatsby|by F. Scott Fitzgerald|Fitzgerald F. Scott
How to Read Literature Like a Professor|by Thomas C. Foster|Foster Thomas C.
Man's Search for Meaning|by Viktor E. Frankl|Frankl Viktor E.
The Inner Game of Tennis: The Classic Guide to the Mental Side of Peak Performance|by W. Timothy Gallwey|Gallwey W. Timothey
Stress Test: Reflections on Financial Crises|by Timothy F. Geithner|Geithner Timothy F.
David and Goliath: Underdogs, Misfits, and the Art of Battling Giants|by Malcolm Gladwell|Gladwell Malcolm
The Tipping Point: How Little Things Can Make a Big Difference|by Malcolm Gladwell|Gladwell Malcolm
The Dip: A Little Book That Teaches You When to Quit|by Seth Godin|Godin Seth
Can't Hurt Me|by David Goggins|Goggins David
Lord of the Flies|by William Golding|Golding William
Rogue Lawyer|by John Grisham|Grisham John
Relentless: From Good to Great to Unstoppable|by Tim S. Grover and Shari Lesser Wenk|Grover Tim S. Wenk Shari Lesser
Free Will|by Sam Harris|Harris Sam
Lying|by Sam Harris|Harris Sam
The Fab 5: The Scrapbook of a Revolution|by Hannah Harshe and M. Earl Smith|Harshe Hannah Smith M. Earl
The Illustrated A Brief History of Time: The Universe in a Nutshell|by Stephen Hawking|Hawking Stephen
A Farewell to Arms|by Ernest Hemingway|Hemingway Ernest
For Whom the Bell Tolls|by Ernest Hemingway|Hemingway Ernest
Zen in the Art of Archery|by Eugen Herrigel|Herrigel Eugen
Arguably: Selected Essays|by Christopher Hitchens|Hitchens Christopher
Hitch 22: A Memoir|by Christopher Hitchens|Hitchens Christopher
Letters to a Young Contrarian|by Christopher Hitchens|Hitchens Christopher
The True Believer: Thoughts on the Nature of Mass Movements|by Eric Hoffer|Hoffer Eric
The Start-Up of You: Adapt to the Future, Invest in Yourself, and Transform Your Career|by Reid Hoffman and Ben Casnocha|Hoffman Reid Casnocha Ben
Ben Hogan's Five Lessons: The Modern Fundamentals of Golf|by Ben Hogan|Hogan Ben
Ego is the Enemy: The Fight to Master Our Greatest Opponent|by Ryan Holiday|Holiday Ryan
The Obstacle Is the Way: The Timeless Art of Turning Trials into Triumph|by Ryan Holiday|Holiday Ryan
Stillness Is the Key|by Ryan Holiday|Holiday Ryan
The Archivist's Story|by Travis Holland|Holland Travis
Why Does the World Exist?: An Existential Detective Story|by Jim Holt|Holt Jim
The Keeper: The Unguarded Story of Tim Howard|by Tim Howard with Ali Benjamin|Howard Tim Benjamin Ali
Delivering Happiness: A Path to Profits, Passion, and Purpose|by Tony Hsieh|Hsieh Tony
This Is Not a T-Shirt: A Brand, a Culture, a Community—a Life in Streetwear|by Bobby Hundreds|Hundreds Bobby
Brave New World|by Aldous Huxley|Huxley Aldous
Einstein: His Life and Universe|by Walter Isaacson|Isaacson Walter
Steve Jobs: The Exclusive Biography|by Walter Isaacson|Isaacson Walter
I Can't Accept Not Trying: Michael Jordan on the Pursuit of Excellence|by Michael Jordan and Sandro Miller|Jordan Michael Miller Sandro
The Adventures of Adam Raccoon: Race to Victory Mountain|by Glen Keane|Keane Glen
Profiles in Courage|by John F. Kennedy|Kennedy John F.
On the Road|by Jack Kerouac|Kerouac Jack
The Autobiography of Martin Luther King Jr|by Martin Luther King Jr (edited by Clayborne Carson)|King Jr Martin Luther
Rich Dad, Poor Dad|by Robert T. Kiyosaki and Sharon Lechter|Kiyosaki Robert T. Lechter Sharon
Steal Like an Artist: 10 Things Nobody Told You About Being Creative|by Austin Kleon|Kleon Austin
Shoe Dog: A Memoir by the Creator of NIKE|by Phil Knight|Knight Phil
The Sixth Extinction: An Unnatural History|by Elizabeth Kolbert|Kolbert Elizabeth
To Kill a Mockingbird|by Harper Lee|Lee Harper
Practice Perfect: 42 Rules for Getting Better at Getting Better|by Doug Lemov, Katie Yezzi and Erica Woolway|Lemov Doug Yezzi Katie Woolway Erica
Freakonomics: A Rogue Economist Explores the Hidden Side of Everything|by Steven D. Levitt and Stephen J. Dubner|Levitt Steven D. Dubner Stephen J.
The Big Short: Inside the Doomsday Machine|by Michael Lewis|Lewis Michael
Flash Boys: A Wall Street Revolt|by Michael Lewis|Lewis Michael
Liar's Poker|by Michael Lewis|Lewis Michael
The Undoing Project: A Friendship That Changed Our Minds|by Michael Lewis|Lewis Michael
Mr g: A Novel About the Creation|by Alan Lightman|Lightman Alan
How to Spend $75 Billion to Make the World a Better Place|by Bjørn Lomborg|Lomborg Bjørn
Buffett: The Making of an American Capitalist|by Roger Lowenstein|Lowenstein Roger
The New Way Things Work|by David Macaulay|Macaulay David
Swim with the Sharks Without Being Eaten Alive: Outsell, Outmanage, Outmotivate, and Outnegotiate Your Competition|by Harvey MacKay|MacKay Harvey
The Greatest Salesman in the World|by Og Mandino|Mandino Og
El coronel no tiene quien le escriba|de Gabriel García Márquez|Márquez Gabriel García
Make Your Bed: Little Things That Can Change Your Life...And Maybe the World|by William H. McRaven|McRaven William H.
7 Men: And the Secret of Their Greatnes|by Eric Metaxas|Metaxas Eric
Above the Line: Lessons in Leadership and Life from a Championship Season|by Urban Meyer and Wayne Coffey|Meyer Urban Coffey Wayne
The Accidental Billionaires: The Founding of Facebook|by Ben Mezrich|Mezrich Ben
The Crucible|by Arthur Miller|Miller Arthur
Stuff Matters: Exploring the Marvelous Materials That Shape Our Man-Made World|by Mark Miodownik|Miodownik Mark
The Wall Street Journal Guide to Understanding Money and Investing|by Kenneth M. Morris, Virginia B. Morris and Alan M. Siegel|Morris Kenneth M. Morris Virginia B. Siegel Alan M. 
The World's Shortest Stories|by Steve Moss|Moss Steve
The Mindful Athlete: Secrets to Pure Performance|by George Mumford|Mumford George
Thing Explainer: Complicated Stuff in Simple Words|by Randall Munroe|Munroe Randall
What If? Serious Scientific Answers to Absurd Hypothetical Questions|by Randall Munroe|Munroe Randall
How To: Absurd Scientific Advice for Common Real-World Problems|by Randall Munroe|Munroe Randall
Deep Work|by Cal Newport|Newport Cal
Digital Minimalism|by Cal Newport|Newport Cal
The Forgotten|by Bishop O'Connell|O'Connell Bishop
The Stolen|by Bishop O'Connell|O'Connell Bishop
The Road to Wigan Pier|by George Orwell|Orwell George
Animal Farm|by George Orwell|Orwell George
1984|by George Orwell|Orwell George
A Tale for the Time Being|by Ruth Ozeki|Ozeki Ruth
Why Soccer Matters|by Pelé and Brian Winter|Pelé Winter Brian
Harvey Penick's Little Red Book: Lessons and Teachings From a Lifetime of Golf|by Harvey Penick and Bud Shrake|Penick Harvey
And If You Play Golf, You're My Friend: Further Reflections of a Grown Caddie|by Harvey Penick and Bud Shrake|Penick Harvey
12 Rules for Life: An Antidote to Chaos|by Jordan B. Peterson|Peterson Jordan B.
Drive: The Surprising Truth About What Motivates Us|by Daniel H. Pink|Pink Daniel H.
Zen and the Art of Motorcycle Maintenance: An Inquiry Into Values|by Robert M. Pirsig|Pirsig Robert M.
The Last Days of Socrates|by Plato (translated by Hugh Tredennick)|Plato
The War of Art|by Steven Pressfield|Pressfield Steven
The Hoops Whisperer: On the Court and Inside the Heads of Basketball's Best Players|by Idan Ravin|Ravin Idan
How I Built This|by Guy Raz|Raz Guy
Letters to a Young Poet|by Rainer Maria Rilke (translated by MD Herter Norton)|Rilke Maria Rainer
Don't Burn This Book: Thinking for Yourself in an Age of Unreason|by Dave Rubin|Rubin Dave
Le Petit Prince|d'Antoine de Saint-Exupéry|Saint-Exupéry Antoine
On Beauty|by Elaine Scarry|Scarry Elaine
Revolver: A Menacing Stranger. Stolen Gold. And a Loaded Gun.|by Marcus Sedgwick|Sedgwick Marcus
Snow Flower and the Secret Fan|by Lisa See|See Lisa
The Right Side of History: How Reason and Moral Purpose Made the West Great|by Ben Shapiro|Shapiro Ben
The Signal and the Noise: Why So Many Predictions Fail—But Some Don't|by Nate Silver|Silver Nate
Practical Ethics, Second Edition|by Peter Singer|Singer Peter
Marx: A Brief Insight|by Peter Singer|Singer Peter
Philosophy in 50 Milestone Moments: A Timeline of Philosophical Landmarks|by Dan Smith|Smith Dan
The Pearl|by John Steinbeck|Steinbeck John
Cannery Row|by John Steinbeck|Steinbeck John
The Upstarts: How Uber, Airbnb, and the Killer Companies of Silicon Valley are Changing the World|by Brad Stone|Stone Brad
The Everything Store: Jeff Bezos and the Age of Amazon|by Brad Stone|Stone Brad
Fooled by Randomness: The Hidden Role of Chance in Life and in the Markets|by Nassim Nicholas Taleb|Taleb Nassim Nicholas
The Black Swan, Second Edition: The Impact of the Highly Improbable|by Nassim Nicholas Taleb|Taleb Nassim Nicholas
The Bed of Procrustes: Philosophical and Practical Aphorisms|by Nassim Nicholas Taleb|Taleb Nassim Nicholas
Antifragile: Things That Gain from Disorder|by Nassim Nicholas Taleb|Taleb Nassim Nicholas
Through My Eyes: A Quarterback's Journey|by Tim Tebow|Tebow Tim
Zero to One: Notes on Startups, or How to Build the Future|by Peter Thiel and Blake Masters|Thiel Peter Masters Blake
Doonesbury: The Original Yale Cartoons|by Garry Trudeau|Trudeau Garry
The Adventures of Tom Sawyer|by Mark Twain|Twain Mark
Astrophysics for People in a Hurry|by Neil DeGrasse Tyson|Tyson Neil DeGrasse
The Art of War|by Sun Tzu|Tzu Sun
The Art of the Short Game: Tour-Tested Secrets for Getting Up and Down|by Stan Utley and Matthew Rudy|Utley Stan Rudy Matthew
Elon Musk: Tesla, SpaceX, and the Quest for a Fantastic Future|by Ashlee Vance|Vance Ashlee
Automobiles That Changed History|by Saverio Villa|Villa Saverio
Why We Sleep: Unlocking the Power of Sleep and Dreams|by Matthew Walker|Walker Matthew
The Captain Class: A New Theory of Leadership|by Sam Walker|Walker Sam
Consider the Lobster and Other Essays|by David Foster Wallace|Wallace David Foster
This Is Water: Some Thoughts, Delivered on a Significant Occasion, about Living a Compassionate Life|by David Foster Wallace|Wallace David Foster
The Indespensable Calvin and Hobbes|by Bill Watterson|Watterson Bill
The Authoratative Calvin and Hobbes|by Bill Watterson|Watterson Bill
Attack of the Deranged Mutant Killer Monster SNOW GOONS|by Bill Watterson|Watterson Bill
There's Treasure Everywhere|by Bill Watterson|Watterson Bill
Something Under the Bed is Drooling|by Bill Watterson|Watterson Bill
The Revenge of the Baby-Sat|by Bill Watterson|Watterson Bill
Calvin and Hobbes|by Bill Watterson|Watterson Bill
The Vocation Lectures|by Max Weber|Weber Max
Mrs. Dalloway|by Virginia Woolf|Woolf Virginia
Fluent Forever: How to Learn Any Language Fast and Never Forget It|by Gabriel Wyner|Wyner Gabriel
The 5th Wave|by Rick Yancey|Yancey Rick
The Infinite Sea|by Rick Yancey|Yancey Rick
Goals: How to Get the Most Out of Your Life|by Zig Ziglar|Ziglar Zig
The Book Thief|by Markus Zusak|Zusak Markus
The Selected Poems of Robert Frost, Illustrated Edition||Frost Robert
String Theory: David Foster Wallace on Tennis||Wallace David Foster
The Bible: New International Version||
The Talent Code: Greatness Isn't Born. It's Grown. Here's How.|by Daniel Coyle|Coyle Daniel
The Little Book of Talent: 52 Tips for Improving Your Skills|by Daniel Coyle|Coyle Daniel
My Turn: A Life of Total Football|by Johann Cruyff|Cruyff Johann
Unweaving the Rainbow: Science, Delusion and the Appetite for Wonder|by Richard Dawkins|Dawkins Richard
Surely You're Joking, Mr. Feynman: Adventures of a Curious Character||Feynman Richard
Civilization and Its Discontents|by Sigmund Freud|Freud Sigmund
Christopher Hitchens: The Last Interview||Hitchens Christopher
The Mind's I: Fantasies and Reflections on Self and Soul|by Douglas R. Hofstadter and Daniel C. Dennet|Hofstadter Douglas R. Dennet Daniel C.
User Friendly: How the Hidden Rules of Design are Changing the Way We Live, Work, and Play|by Cliff Kuang with Robert Fabricant|Kuang Cliff Fabricant Robert
Inverting the Pyramid: The History of Soccer Tactics|by Jonathan Wilson|Wilson Jonathan
The Alchemist|by Paolo Coelho|Coelho Paolo
Vincent van Gogh: A Life in Letters||Van Gogh Vincent
Building Indestructible Athletes: The Small Things That Make Athletes Great|by Donny Mateaki|Mateaki Donny
The Moral Animal: Why We Are the Way We Are: The New Science of Evolutionary Psychology|by Robert Wright|Wright Robert
When Einstein Walked with Gödel: Excursions to the Edge of Thought|by Jim Holt|Holt Jim
Go Set a Watchman|by Harper Lee|Lee Harper
The Red Pony|by John Steinbeck|Steinbeck John
Ishmael: A Novel|by Daniel Quinn|Quinn Daniel
The Picture of Dorian Gray|by Oscar Wilde|Wilde Oscar
The Rose That Grew From Concrete|by Tupac Shakur|Shakur Tupac
Yosemite: An American Treasure|by Kenneth Brower|Brower Kenneth
River Out of Eden: A Darwinian View of Life|by Richard Dawkins|Dawkins Richard
The Art of Learning: An Inner Journey to Optimal Performance|by Josh Waitzkin|Waitzkin Josh
The Book of Five Rings|by Miyamoto Musashi|Musashi Miyamoto
A Life Well Played: My Stories|by Arnold Palmer|Palmer Arnold
The Name of the Rose|by Umberto Eco|Eco Umberto
Open: An Autobiography|by Andre Agassi|Agassi Andre
Things Fall Apart|by Chinua Achebe|Achebe Chinua
Originals: How Non-Conformists Move the World|by Adam Grant|Grant Adam
The 4-Hour Chef: The Simple Path to Cooking Like a Pro, Learning Anything, and Living the Good Life|by Timothy Ferriss|Ferriss Timothy
Walden|by Henry David Thoreau|Thoreau David Henry
Stiff Upper Lip, Jeeves|by PG Wodehouse|Wodehouse PG
Night|by Elie Wiesel|Wiesel Elie
Why Don't We Learn from History?|by BH Lidell Hart|Hart Lidell HB
Mortality|by Christopher Hitchens|Hitchens Christopher
What I Talk About When I Talk About Running: A Memoir|by Haruki Murakami|Murakami Haruki
Tribe of Mentors: Short Life Advice from the Best in the World|by Timothy Ferriss|Ferriss Timothy
The 4-Hour Body: An Uncommon Guide to Rapid Fat-Loss, Incredible Sex, and Becoming Superhuman|by Timothy Ferriss|Ferriss Timothy
The Art of Travel|by Alain de Botton|De Botton Alain
The Screwtape Letters|by CS Lewis|Lewis CS
Brief Interviews with Hideous Men: Stories|by David Foster Wallace|Wallace Foster David
The Moral Landscape: How Science Can Determine Human Values|by Sam Harris|Harris Sam
100 Selected Poems|by e. e. cummings|Cummings EE
Incompleteness: The Proof and Paradox of Kurt Gödel|by Rebecca Goldstein|Goldstein Rebecca
Kafka on the Shore|by Haruki Murakami|Murakami Haruki
A Supposedly Fun Thing I'll Never Do Again: Essays and Arguments|by David Foster Wallace|Wallace Foster David
The Death of Ivan Ilych and Other Stories|by Leo Tolstoy (translated by Louise and Aylmer Maude)|Tolstoy Leo
Greenlights|by Matthew McCounaghey|McCounaghey Matthew
Oblivion: Stories|by David Foster Wallace|Wallace Foster David
The Meaning of It All: Thoughts of a Citizen-Scientist|by Richard P. Feynman|Feynman P. Richard
The End Is Always Near: Apocalyptic Moments, from the Bronze Age Collapse to Nuclear Near Misses|by Dan Carlin|Carlin Dan
The Innovators: How a Group of Hackers, Geniuses, and Geeks Created the Digital Revolution|by Walter Isaacson|Isaacson Walter
The Culture Code: The Secrets of Highly Successful Groups|by Daniel Coyle|Coyle Daniel
Where the Red Fern Grows|by Wilson Rawls|Rawls Wilson
Siddhartha: An Indian Poem|by Hermann Hesse|Hesse Hermann
Of Mice and Men|by John Steinbeck|Steinbeck John
The Metamorphosis and Other Stories|by Franz Kafka|Kafka Franz
Existentialism from Dostoevsky to Sartre: Basic Writings of Existentialism by Kaufmann, Kierkegaard, Nietzsche, Jaspers, Heidegger, and Others|selected and introduced by Walter Kaufmann|Kaufmann Walter
Myth and Meaning: Cracking the Code of Culture|by Claude Lévi-Strauss|Lévi-Strauss Claude
Beyond Good and Evil: Prelude to a Philosophy of the Future|by Friedrich Nietzsch (translated by Walter Kaufman)|Nietzsche Friedrich
Notes from Underground, The Double and Other Stories|by Fyodor Dostoevsky (translated by Constance Garnett)|Dostoevsky Fyodor